R 700  700
SO pics/greystone.xpm
NO pics/redbrick.xpm
EA pics/bluestone.xpm
WE pics/eagle.xpm
F pics/greystone.xpm
C pics/wood.xpm
S pics/barrel.xpm

111111120
100000010
100100010
100010010
10000E010
100000010
100000010
111111110